1,1,1,1,1,1,1,1,1,1,1,1,1,1,1,1,1,1,1,1
1,0,0,1,0,0,0,0,0,0,0,0,0,0,0,0,1,P,0,1
1,0,0,1,0,0,0,0,0,0,0,0,0,0,0,0,1,1,0,1
1,0,0,1,0,E,0,0,0,0,0,0,0,0,0,0,0,0,0,1
1,0,0,1,0,0,0,0,0,0,0,0,0,0,0,0,0,0,0,1
1,0,0,1,0,0,0,0,0,0,0,0,0,0,0,0,0,0,0,1
1,0,0,1,0,0,0,0,0,0,0,0,0,0,0,0,0,0,0,1
1,0,0,1,0,0,0,0,0,0,0,0,0,1,L,L,L,1,1,1
1,0,0,1,0,E,0,0,0,0,1,1,1,1,0,0,0,T,0,1
1,0,0,1,0,0,0,0,0,0,1,0,1,0,0,0,0,1,1,1
1,0,0,Y,0,0,0,1,1,1,1,0,1,0,0,0,0,0,0,1
1,0,0,1,0,0,0,0,0,0,1,1,1,1,0,E,0,0,0,1
1,0,0,1,0,0,0,0,K,0,1,0,0,L,0,0,0,0,0,1
1,0,0,1,0,0,0,0,0,0,1,S,0,L,0,0,0,0,0,1
1,1,1,1,1,1,1,1,1,1,1,1,1,1,1,1,1,1,1,1